## Man and Machine & Coming to your Tank

to aspire (v) -- to want to achieve something or to be successful, especially in your career
to batter (v) -- to hit something very hard several times
to blindside (v) -- to catch unawares, especially with harmful consequences
to brace (v) -- to get ready for something unpleasant
a brawn (n) -- physical strength, especially when compared with mental skill and intelligence
cacophonous (adj) -- having an unpleasant sound
a contention (n) -- disagreement between people or groups
a combustion (n) -- the act of burning something
hardened (adj) -- someone who is ~ has had a lot of difficult or unpleasant experiences and is no longer much affected by such things
a hulk (n) -- the shape of something such as a large ship or building, especially after the inside of it has been destroyed by fire
nimble (adj) -- able to move quickly and easily
a pace (n) -- the speed at which something happens or is done
to pit (v) -- to make small marks or holes in a surface
to roam (v) -- to move or travel with no particular purpose
rubble (n) -- the remains of something that has been destroyed or broken up
to scrap (v) -- to get rid of something
a shank (n) -- the part of your leg between your knee and your foot
to shatter (v) -- to break suddenly into a lot of small pieces
a stride (n) -- a long confident step

## The Grind & Mortal Combat Party

an allure (n) -- a special, exciting, and attractive quality that someone or something has
a backbone (n) -- the row of small bones that goes down the middle of your back (b...)
a conviction (n) -- a strong belief or opinion about something
a cringe (n) -- a quick slight movement away from something that is unpleasant or frightening
to crigne (v) -- to feel embarrassed or ashamed about something
a delight (n) -- a feeling of great happiness and pleasure
to delight (v) -- to give someone a lot of enjoyment or pleasure
desolate (adj) -- a ~ place is completely empty with no people or pleasant features in it
desolate (adj) -- feeling very sad and lonely
an expanse (n) -- a large area of land, water, or sky
a grind (n) -- something that is hard work, boring, and tiring because it takes a lot of your time and energy
to mend (v) -- to repair something that is broken or damaged so that it can be used again
overdue (adj) -- if something is ~, it should have been done before now
spellbound (adj) -- so impressed by something that you do not pay attention to anything else
a spine (n) -- the row of bones down or along the middle of a human’s or animal’s back (s...)
a spine (n) -- the edge of a book where all the pages are fixed together
to squeal (v) -- to make a long high sound

## All as One

asunder (adv) -- apart
blight (n) -- something that damages or spoils something else
enigma (n) -- someone or something that is mysterious and difficult to understand
to scorch (v) -- if extreme heat ~s you, it is so hot that it is painful
to stamp out (pv) -- to end or extinguish by forceful means
to strive (v) -- to make a lot of effort to achieve something
to stumble (v) -- to encounter by chance
to stumble (v) -- to miss a step and fall or nearly fall

## Structure and Interpretation of Computer Programs

rife (adj) -- if something bad or unpleasant is ~, there is a lot of it

## Homestuck

lukewarm (adj) -- not hot or cold enough to be enjoyable
lukewarm (adj) -- not very enthusiastic or interested
precarious (adj) -- likely to change or become dangerous without warning
preemptive (adj) -- said or done before someone else has a chance to act or attack so that their plans or actions are prevented from happening
tomfoolery (n) -- behavior that is not sensible
sleuth (n) -- a detective who follows a trail
foolhardy (adj) -- ignoring obvious dangers in a stupid way
to covet (v) -- wish, long, or crave for (something, especially the property of another person)
a feud (n) -- an angry disagreement between two people or groups that continues for a long time
embroiled (adj) -- involved in a difficult situation
a lout (n) -- an unpleasant young man who behaves badly, especially in public
unscrupulous (adj) -- willing to do things that are unfair, dishonest, or illegal

## Guards, Guards!

to cease (v) -- to stop happening or continuing
a conjuration (n) -- calling up a spirit or devil
a contempt (n) -- a feeling that someone or something is unimportant and deserves no respect
detritus (n) -- waste that remains after something has been destroyed, used, or finished
to fathom (v) -- to understand something complicated or mysterious
feeble (adj) -- physically weak, especially because you are old or sick
fetid (adj) -- ~ water or air has a very unpleasant smell, usually caused by decay
a malignity (n) -- quality of being disposed to evil; intense ill will
to rear (v) -- to rise up in height
recumbent (adj) -- lying down on your back
to rummage (v) -- to search for something among a lot of other things
to skulk (v) -- to move around or to wait somewhere in a secret way, especially because you are going to do something bad
sodden (adj) -- completely wet
a titter (n) -- a quiet laugh that you make because you are nervous or embarrassed
vague (adj) -- not clearly or fully explained
vitriolic (adj) -- ~ language or behavior is cruel and full of hate

## Bob Nylstrom's books

ginormous (adj) -- extremely large
a drudgery (n) -- boring and unpleasant work that you have to do
innocuous (adj) -- not likely to offend or upset anyone
a menagerie (n) -- a collection of live animals for study or display
a concession (n) -- something that you choose to do because it is sensible or convenient for the situation you are in
a misnomer (n) -- a name or description that is incorrect or inappropriate
sans (prep) -- without
to veer (v) -- to suddenly move in a different direction
a rigor (n) -- the quality of being strict or severe
grandeur (n) -- the quality of being magnificent or splendid or grand
fervent (adj) -- very enthusiastic and sincere, especially about something you believe in or support
a diatribe (n) -- a speech or piece of writing that angrily attacks someone or something
to elide (v) -- to leave out a sound when you say a word or group of words, for example when you say it quickly in ordinary conversation
benign (adj) -- kind and nice
enticing (adj) -- something that is ~ is so good or attractive that you want to have it or do it very much
to vie (v) -- compete for something; engage in a contest; measure oneself against others
contrived (adj) -- false or artificial
acquainted (adj) -- if you are ~ with something, you know about it

## Sunstone

bespectacled (adj) -- wearing glasses

## Inform7

impetus (n) -- a force that helps something to happen or develop more quickly
tractable (adj) -- easy to deal with
